+++++++++++++++++
+       +       F
+++ + +++ +++++++
S   + +         +
+ + +++++++++++ +
+++           + +
+ + ++ ++ +++ + +
+   ++    +   + +
+++++++++++ +++ +
+           + + +
+ +++++++++++   +
+             + +
+++++++++++++++++
